.S##......
#.##..###.
#.###.###.
#.....###.
###.#####S